R 1280 720
NO textures/1.xpm
SO textures/2.xpm
WE textures/3.xpm
EA textures/konoha.xpm
S textures/osel.xpm
F 184,113,255
C 51,198,230

        1111111111111111111111111
        1000000000110000000000001
        1011000001110000002200001
        1001000000000000002200001
111111111011000001110000000000001
1000000000110000011101111110111111
11110111111111011100000010001
11110111111111011101010010001
11000000110101011100000010001
10002000000000001100000010001
10000000000000001101010000001
11000001110101011111011110N0111
11110111 1110101 101111010021
11111111 1111111 11111111111